
#0 = dot
#1 = pacman
#2 = wall

This is a clone of the original pacman level.
This numbers represent objects to be loaded within
the scene object. 

Anything can go behind the START command which will
tell the parser when the level is ready to be loaded.

START
2222222222222222222
2000000002000000002
2022022202022202202
2000000000000000002
2022020222220202202
2000020002000200002
2222022202022202222
2222020000000202222
2222020220220202222
2000000200020000002
2222020222220202222
2222020000000202222
2222020222220202222
2000000002000000002
2022022202022202202
2002000001000002002
2202020222220202022
2000020002000200002
2022222202022222202
2000000000000000002
2222222222222222222
